0 0 0 0 0 0 0 0 0 0 0 0 0 0 0 0 0 0 0 0 0 0 0 0 0 0 0 0 0 0 0 0
0 1 1 1 1 1 1 1 1 1 1 1 1 1 1 1 1 1 1 1 1 1 1 1 5 5 5 5 5 5 5 0
0 1 2 2 4 2 2 1 1 3 3 1 1 3 3 4 3 3 1 1 1 1 1 1 5 5 5 5 5 5 5 0
0 1 2 2 4 2 2 1 1 3 3 1 1 3 3 4 3 3 1 1 1 1 1 1 5 5 5 5 5 5 5 0
0 1 2 2 4 2 2 1 1 3 3 1 1 3 3 4 3 3 1 1 1 1 1 1 5 5 5 5 5 5 5 0
0 1 2 2 4 2 2 1 1 3 3 1 1 3 3 4 3 3 1 1 1 1 1 1 5 5 5 5 5 5 5 0
0 1 2 2 4 2 2 1 1 3 3 1 1 3 3 4 3 3 1 1 1 1 1 1 5 5 5 5 5 5 5 0
0 1 2 2 4 2 2 1 1 3 3 1 1 3 3 4 3 3 1 1 1 1 1 1 5 5 5 5 5 5 5 0
0 1 2 2 4 2 2 1 1 3 3 1 1 3 3 4 3 3 1 1 1 1 1 1 5 5 5 5 5 5 5 0
0 1 2 2 4 2 2 1 1 3 3 1 1 3 3 4 3 3 1 1 1 1 1 1 5 5 5 5 5 5 5 0
0 1 2 2 4 2 2 1 1 3 3 1 1 3 3 4 3 3 1 1 1 1 1 1 5 5 5 5 5 5 5 0
0 1 2 2 4 2 2 1 1 3 3 1 1 3 3 4 3 3 1 1 1 1 1 1 5 5 5 5 5 5 5 0
0 1 2 2 4 2 2 1 1 3 3 1 1 3 3 4 3 3 1 1 1 1 1 1 5 5 5 5 5 5 5 0
0 1 2 2 4 2 2 1 1 3 3 1 1 3 3 4 3 3 1 1 1 1 1 1 5 5 5 5 5 5 5 0
0 1 2 2 4 2 2 1 1 3 3 1 1 3 3 4 3 3 1 1 1 1 1 1 5 5 5 5 5 5 5 0
0 1 2 2 4 2 2 1 1 3 3 1 1 3 3 4 3 3 1 1 1 1 1 1 5 5 5 5 5 5 5 0
0 1 1 1 1 1 1 1 1 1 1 1 1 1 1 1 1 1 1 1 1 1 1 1 5 5 5 5 5 5 5 0
0 0 0 0 0 0 0 0 0 0 0 0 0 0 0 0 0 0 0 0 0 0 0 0 0 0 0 0 0 0 0 0